NO assets/map/dungeon_wall_9.png
SO assets/map/dungeon_wall_10.png
WE assets/map/dungeon_wall_1.png
EA assets/map/dungeon_wall_2.png

F 111,111,111
C 22,30,0

        1111111111111111111111111
        1000000000110000000000001
        1011000001110000000000001
        1001000000000I0000000W001
111111111011000001110000000000001
100000000011000001110111111111111
111101111111110111000000010001
11110111111011011101010000001
11000000110101011100000010001
10000000000000000000000010001
10000000000000001101010010001111111111111
1100000001010101111101111000000000000000111
1111111101110101 1011 101000111111111111
111111111  1111  1111 1111111