NO assets/map/dungeon_wall_1.png
SO assets/map/dungeon_wall_1.png
WE assets/map/dungeon_wall_1.png
EA assets/map/dungeon_wall_1.png

F 110,100,11
C 22,30,0

        1111111111111111111111111
        1000000000110000000000001
        1011000001110000000000001
        1001000000000000000000001
111111111011000001110000000000001
100000000011000001110111111111111
111101111111110111000000010001
11110111111 11111101010010001
11000000110101011100000010001
10000000000000001100000010001
10000000000000001101010010001111111111111
11000000010101011111011110E0000000000000111
1111111101110101 1011 101000111111111111
111111111  1111  1111 1111111