NO assets/map/dungeon_wall_9.png
SO assets/map/dungeon_wall_3.png
WE assets/map/dungeon_wall_4.png
EA assets/map/dungeon_wall_10.png

F 84,84,84
C 22,30,0

11111111111
10000S00001
1000P0K0001
11111D11111
10000000001
10000000001
10000000001
10000K00001
10000000001
10000000001
100I000I001
10000000001
10011D11001
10010001001
10010001001
10010001001
10010001001
10010B01001
10011111001
1000000P001
10000000001
10000000001
10000000001
1I000000K01
11111D11111
10K00000001
10000I00001
11111111111