NO assets/map/dungeon_wall_1.png
SO assets/map/dungeon_wall_1.png
WE assets/map/dungeon_wall_2.png
EA assets/map/dungeon_wall_2.png

F 218,218,218
C 28,13,120

11111111111
10000000001
10000000001
11111011111
1S000000001
10000000001
10000000001
10000000001
10000000001
10011111001
10011111001
10011111001
10011111001
10011111001
10011111001
10011111101
10000000001
10000000001
10000000001
10000000001
10000000001
10000000001
10000000001
1I000000001
11011111111
10000000001
10000000001
11111111111