NO assets/map/dungeon_wall_1.png
SO assets/map/dungeon_wall_1.png
WE assets/map/dungeon_wall_2.png
EA assets/map/dungeon_wall_2.png

F 218,218,218
C 28,13,120

11111111111
1W000000001
10000000001111111111111111111111111
10000000001000000000000000000000001
11111011111000000000100000000000001
10000000001000000000100000000000001
10000000000000000000100000000000001
11111100001000011111100000000000001
10000000001000000000000000000000001
10000000001111101111111111111111111
111011111110000001
10000000001000000111111
100000000010000000000001
1000011111100000010000001
10000000000000000110000001
100000000010000001010000001
1111111011100000010010000001
10000000001110111100010000001
100000000010000000000010000001
11111011111000000000010000001
1000000000000000000000000001
100000000010000000010000001
10000000001111111110000001
1111101111100000000000001
100000000000000000000001
10000000000000000000001
1111111111111111111111