NO assets/map/dungeon_wall_1.png
SO assets/map/dungeon_wall_9.png
WE assets/map/dungeon_wall_3.png
EA assets/map/dungeon_wall_10.png

F 84,84,84
C 22,30,0

              11111111111111111111111111
11111111111111100000000000000000000000011111111111111
10000000000000100000000000000000000000010000000000001
1000000000000000000000000N000000000000000000000000001
10000000000000100000000000000000000000010000000000001
11111111111111100000000000000000000000011111111111111
10000000000000100000000000000000000000010000000000001
10000000000000000000000000000000000000000000000000001
10000000000000100000000000000000000000010000000000001
11111111111111111111111111111111111111111111111111111