NO assets/map/dungeon_wall_10.png
SO assets/map/dungeon_wall_9.png
WE assets/map/dungeon_wall_2.png
EA assets/map/dungeon_wall_1.png

F 84,84,84
C 22,30,0

       1111111111111111111
 1111111K0000000N000000001111111
 1I000010000000000000000010000K1
 1000K0D00000000000000000D00P001
 1000001000000000000000001000001
 1111111000000000000000001111111
 1I000I1000I0000000000I001I000K1
 100000D000I0000000000I00D000I01
 1I00K01000000000000000001I00001
 1111111000000010100000001111111
    111111111111D111111111111
    111111111110K011111111111
    111111111110I011111111111                                 
    111111111110I011111111111                                
    111111111111D111111111111                                 
    1111111111110111111111111111111111111111111
    100000000000000000000000100000P0000000000I1
    10000000000000000000000K1000000000K0000I001
    100I0000000000I000000000D000000000000000I01
    10000000000I0000000000I0100000P000000000001
    10I000000000000000000000111111111D111111111
    1000I000000000000000I0001000000000000000001
    1111111111111111111111111000000000000000001
                            1000II0P0K0P0II0001
                            1000000P000P00I0001
                            111111111D111111111
                                    101
                                    101
                                    1K1
                                    101
                                    101
                            111111111D11111111
                            1000000000I00000P1
                            1000I00000000I00P1
                            100000000000000IP1
                            1000000000000000P1
                            10000000000000IIP1
                            10000000I0000I00P1
                            100000000B000000P1
                            111111111111111111 
                        
                                            