 NO   assets/map/dungeon_wall_1.png


   SO                                     assets/map/dungeon_wall_1.png
EA                                                         assets/map/dungeon_wall_2.png
                        WE               assets/map/dungeon_wall_2.png

        C 35,19,73
F 124,181, 80

















        111111111111111111111111
        1000000000110000000000001
        1011000001110000000000001
        1001000000000000000000001
111111111011000001110000000000001
100000000011000001110111011111111
11110111111111011100000000001
11110111111111011101010010001
11000000110101011100000010001
10000000000000001100000010001
10000000000000000001010010001
11000001110101011111011110N0111
11110111 1110101 101111010001
11111111 1111111 11111111111111