NO assets/map/dungeon_wall_1.png
SO assets/map/dungeon_wall_1.png
WE assets/map/dungeon_wall_2.png
EA assets/map/dungeon_wall_2.png

F 220,100,0
C 225,30,0

        1111111111111111111111111
        1000000000110000000000001
        1011000001110000000000001
        1001000000000000000000001
111111111011000001110000000000001
100000000000000001110111111111111
11110111111111011000000010001
11110111111111011001010010001
11000000110101011000000010001
10000000000000000000000010001
10000000000000001000000010001
11000001110101011111011110N0111
11110111 1110101 101000000001
11111111 1111111 111111111111