NO assets/map/dungeon_wall_1.png
SO assets/map/dungeon_wall_1.png
WE assets/map/dungeon_wall_2.png
EA assets/map/dungeon_wall_2.png

F 255,233,183
C 171,219,227

1111111111111111111111111111
1E00000000000000000000000001
1000000000000000000000000001
1000000000000000000000000001
1111111111111111111011111111
                  100000001
                 100000001
                100000001
               100000001
              100000001
             100000001
            100000001
           100000001
          100000001
         100000001
        100000001
       100000001
      100000001
     100000001
    100000001
   100000001
  100000001
 100000001
100000001
1111111011111111111111111111
1000000000000000000000000001
1000000000000000000000000001
1000000000000000000000000001
1111111111111111111111111111