NO assets/map/dungeon_wall_1.png
EA assets/map/dungeon_wall_2.png
SO assets/map/dungeon_wall_1.png
WE assets/map/dungeon_wall_2.png

F 15,6
C 40,190,75

111111111111111
111111000111111
111110000011111
111100000001111
111000000000111
110000000000011
100001111100001
110000111000011
111000010000111
111100000001111
1111100S0011111
111111000111111
111111111111111