NO 
SO
WE
EA


F 76,76,76
C 99,99,99


111111
100001
100001
100001110001
100000000001
101100000011
100000001111
100011111111
111111111111