NO assets/map/dungeon_wall_1.png
SO assets/map/dungeon_wall_1.png
WE assets/map/dungeon_wall_2.png
EA assets/map/dungeon_wall_2.png

F 128,128,128
C 10,15,30

111111
100001
100001
100001111111
100E00000001
101010100011
1001000011
10000001
11111111