NO assets/map/dungeon_wall_3.png
SO assets/map/dungeon_wall_9.png
WE assets/map/dungeon_wall_4.png
EA assets/map/dungeon_wall_10.png

F 84,84,84
C 22,30,0

11111111111
10000S000P1
10000000001
11100000111
10000000001
10000000001
10000000001
10000000001
10000000001
10000000001
100I000I001
10000000001
10011111001
10011111001
10011111001
10011111001
100K0000001
10000000001
10000000001
1000000P001
10000000001
10000000001
10000000001
1I000000001
11111D11111
10000000001
10000I00001
11111111111