NO assets/map/dungeon_wall_3.png
SO assets/map/dungeon_wall_9.png
WE assets/map/dungeon_wall_4.png
EA assets/map/dungeon_wall_10.png

F 84,84,84
C 22,30,0

11111111111
10010100001
1001D100001
1001E10000111111111
1001000000000000001
1000000000000000001
1000000000111111111
11111111111