NO assets/map/dungeon_wall_5.png
SO assets/map/dungeon_wall_6.png
WE assets/map/dungeon_wall_7.png
EA assets/map/dungeon_wall_8.png

F 0,0,168
C 22,30,0

11111111111
1S000000001
10000000001111111111111111111111111
10000000001000000000000000000000001
1111101111100000I0001000000I0000001
100000000P10000000I0100000000000001
1000000000I000000000100000000I00001
1111110000100001111110I0000P0000001
1000000000100I0000000000000I0000001
100000I0001111101111111111111111111
111011111110000001
10000000001000000111111
100000I00010000001000001
1000011111100000010000001
10000I00000000000110000001    1111111111111111111111111
1000000000100I0001010000001   10000000000000000I0000001
1111111011100000010010000001  1000000000P000000I0000001
1I000000001110111100010000001110000000000000000I0000001
1000000I001000000000001000000000000000000000000I00000B1
11111011111000000000010000001110000000000000000I0000001
100000I000000000000010000001  1000000000P000000I0000001
100000000010000000010000001   1111111111111111111111111
100000000011111111100I0001
1111101111100000000000001
1I000000000000000I000001
100000I000000000000I001
1111111111111111111111