NO assets/map/dungeon_wall_9.png
SO assets/map/dungeon_wall_10.png
WE assets/map/dungeon_wall_1.png
EA assets/map/dungeon_wall_2.png

F 84, 84, 84
C 22,30,0

        1111111111111111111111111
        1I0000000110P000K00000001
        100000000D000000000000001
        10P00000011B0000000000W01
111111111011000001100000000000001
1I00K0000011000001100000000011111
11111111111111011110P00000001
11111111111111D1111111001D111
10000000000000011100000010001
100I000000000000D000P00010001
100I00000000000111I000001000111111111111
10000000P0010111111101111000D000000000I1
10000000011100K1 1K0011K0000111111111111
1111111111 11111 111111111111