NO assets/map/dungeon_wall_9.png
SO assets/map/dungeon_wall_10.png
WE assets/map/dungeon_wall_1.png
EA assets/map/dungeon_wall_2.png

F 84, 84, 84
C 22,30,0

        1111111111111111111111111
        1000000001110000000000001
        1001000000D00000000000001
        1001000000D0000000000W001
111111111011000001110000000000001
1I0000000011000001110000000011111
11110111111111011100000000001
11110111111111011101010000001
11000000000000011100000010001
100I0000000000000000000010001
100I0000000000001101010010001111111111111
110000000101010111110111100000000000000I1
1111111101110101 1011 1010001111111111111
111111111  1111  1111 1111111