NO assets/map/dungeon_wall_1.png
SO assets/map/dungeon_wall_9.png
WE assets/map/dungeon_wall_2.png
EA assets/map/dungeon_wall_10.png

F 84,84,84
C 22,30,0

              11111111111111111111111111
111111111111111KIIIIIIIIIIII0000000000011111111111111
1I0000000000001000000000000000000000000100000000K0001
1000K000000000D000000000000000000000000D0000P00000001
10000000000000100000000000000000000000010000000000001
11111111111111100000000000000000000000011111111111111
1I00000000000I10000000000000000000000001I0000000K0001
10000000000000D000000000000000000000000D000000I000001
1I00K00000000010000000000000000000000001I000000000001
11111111111111100000000000101000000000011111111111111
              1111111111111D111111111111
              11111111111100011111111111
              11111111111100011111111111
              1111111111110K011111111111
              1111111111110I011111111111                                    11111111111111111111111111
              1111111111110I011111111111                                    10000000000000P000000I00K1
              11111111111100011111111111                                    100000I00000I0000000000001
              1111111111111D111111111111                                    1000I000000000000000000001
111111111111111111111111110001111111111111111                               100000000000000I0000000001
10000000000000000000000I000I000I000000000000111111111111111111111111111111111000000I000000000000000001
1000I000000000I0000000000000000000000000000010000000000P00000000000000I00000100000000000I00000I0000001
100000000000000000000000000000000K000000000010000000000P0000000000I00000000000000000000000000000000001
100000000I0000000000000000000000000000000000D0000000000P0000000000000I00000010000000000I00000000000001
1000000000000000000000000000000I00000000000010000000000P0000000000000000000010000I000000000I000000I001
1000I000000000000000000000000000000000000000111111111111111D111111111111111110000000000000000000000001
1000000000I000000000000000000I000000000000001IIIIIIIIIIII00SIIIIIIIIIIII000011111111111111111111111111
10101IIIIIIIIIIIIIIIIIIIIIIIIIIIIII00IIIIIII1IIIIIIIIIIII0IIIIIIIIIIIIIIIIIII01
111111111111111111111111111111111111111111111IIIIIIIIIIIIIIIIIIIIIIIIIIIIII0001
                                            1IIIIII00IIIIIIIIIIIIIIIIIIIIIIII01
                                            1IIIIII000IIIIIIIIIIIIIIIIIIIIIIII1
                                            1IIIIII000IIIIIIIIIIIIIIIIIIIIIIII1
                                            1IIIIIIIIIIIIIIIIIIIIIIIIIIIIII0001
                                            1IIIIII000IIIIIIIIIIIII00I00000K001
                                            1IIIIII0000IIIIIII0IIIIIIIIIIIII001
                                            1111111111111111D111111111111111111
                                                           101
                                                           1K1
                                                           1P1
                                                           101
                                                           101
                                                           101
                                                           101
                                                           101
                                            1111111111111111D111111111111111111
                                            1IIIIIIIIIIIII0000IIIIIIIIIIIII00P1
                                            1000I000IIIIIIIIIIIII00IIIIIII000P1
                                            10000IIIIIII00000IIIIIIIIIIIII000P1
                                            1IIIIIIIIIIIIIIIIII0000IIIIIII000P1
                                            1IIIIIIIIIIIIIIIIII00IIIIIII0I000P1
                                            1IIIIII0IIIIIII00IIIIIII0I000I000P1
                                            1IIIIII0I000IIIIIII0I0000IIIIIII0P1
                                            10B00000IIIIIIIIIIIIIIIIIIIIIIIIIP1
                                            11111111111111111111111111111111111    
                                            