NO assets/map/dungeon_wall_5.png
SO assets/map/dungeon_wall_6.png
WE assets/map/dungeon_wall_7.png
EA assets/map/dungeon_wall_8.png

F 0,0,168
C 22,30,0

        1111111111111111111111111
        10000000011100P0000000P01
        10010000000000000K0000001
        10010000000K000000000W001
111111111011000001110P00000000001
1I0000000011000001110000000011111
11110111111111011100000000001
11110111111111011101010000001
11000000000000011100000010001
100I0000000000000000000010001
100I0000000000001101010010001111111111111
110000000101010111110111100000000000000I1
1111111101110101 1011 1010001111111111111
111111111  1111  1111 1111111