NO assets/map/dungeon_wall_5.png
SO assets/map/dungeon_wall_6.png
WE assets/map/dungeon_wall_7.png
EA assets/map/dungeon_wall_8.png

F 0,0,168
C 22,30,0

11111111111
10000S000P1
10000000001
11100000111
10000B00001
10000000001
10000000001
10000000001
10000000001
10000000001
100I000I001
10000000001
10011111001
10011111001
10011111001
10011111001
10000000001
100P0000001
10000000001
1000000P001
10000000001
10000000001
10000000001
1I0000000I1
11111111101
1I000000001
10000000001
11111111111