NO assets/map/dungeon_wall_5.png
SO assets/map/dungeon_wall_6.png
WE assets/map/dungeon_wall_7.png
EA assets/map/dungeon_wall_8.png

F 0,0,168
C 22,30,0

11111111111
1P000S000K1
10000000001
11111D11111
10000000001
10000000001
10000000001
10000000001
10000000001
10000000001
100I000I001
10000000001
10011D11001
10010001001
10010B01001
10011111001
10000000001
10000000001
10000000001
1000000P001
10000000001
10000000001
10000000001
1I000000K01
11111D11111
10K00000001
10000I00001
11111111111