NO assets/map/dungeon_wall_1.png
SO assets/map/dungeon_wall_1.png
WE assets/map/dungeon_wall_2.png
EA assets/map/dungeon_wall_2.png

F 218,218,218
C 28,13,120

11111111111
1S0000P0001
10000000001
11111D11111
10000000001
10000000P01
10000000001
10000000001
10000000001
10011111001
10011111001
10011111001
10011111P01
10011111001
10011111001
11D111111D1
10P00000001
10000000001
10000000001
10000000001
10000000001
10000000001
10000000001
10000000001
11D11111111
10000000001
10000000G01
11111111111