NO assets/map/dungeon_wall_1.png
SO assets/map/dungeon_wall_1.png
WE assets/map/dungeon_wall_2.png
EA assets/map/dungeon_wall_2.png

F 218,218,218
C 28,13,120

11111111111
1W000000001
100000P0001111111111111111111111111
10000000001000000000D00000000000001
11111D11111000P00000100000000000001
10000000001000000000100000P00000001
1000000000D000000000100000000000001
1111110000100001111110000000000P001
100P000000100000P000D00000000000001
100000000011111D111111111111D111111
111D11111110000001
10000000001000000111111
10000000001000000D000001
100001111110P000010000001
10000P0000D000000110000P01
100000000010000001010000001
1111111D1110000P010010000001
1000000000111D111100010000001
100000000010000000000010000001
11111011111000000000010000001
1000000000D0000P0000D0000001
1000000000100000000100000G1
10P00000001111111110000001
11111D1111100000000000001
100000000000000000000001
10000000000000000P00001
1111111111111111111111