WE assets/map/dungeon_wall_2

C 137, 207, 240
SO assets/map/dungeon_wall_1

NO assets/map/dungeon_wall_1



EA assets/map/dungeon_wall_2
F 79, 121, 66


11111111111111111111s
10000010000000000001
10000010000P00000001
10000010000000111101
100000D00000000001P1
10000010000000100101
1D111111111100100101
10000000000100100001
100P0000E00100110001
10000000000100010001
11D1111111D111110001
10010000000000000001
10011100001111111001
10010000001000000001
11111111111111111111