NO assets/map/dungeon_wall_1.png
SO assets/map/dungeon_wall_1.png
WE assets/map/dungeon_wall_2.png
EA assets/map/dungeon_wall_2.png

F 220,100,0
C 225,30,0

        1111111111111111111111111
        1000000000110000000000001
        1011000001110000000000001
        1001000000000000000000001
111111111011000001110000000P00001
1000000000D000000111011111D111111
111101111111110110000000100P1
11110111111111011001010010001
11000000110101011000P00010001
1000G00000000000D000000010001
10000000000000001000000010001
11000001110101011111011110N0111
11110111 1110101 1010000D0001
11111111 1111111 111111111111